x o o T T T T T o o o
o o o T T T T T o o o
o o o o o o o o o o o
o o o T T T T T o o o
o o o T T T T T o o x